######
#. *R#
# \.#
#\ * #
L .\#
######