#######
#     #
#R*   #
# ./  #
L     #
#######