######
#. R #
# \.#
#\ * #
L .\#
######