#######
#R*   #
# .\  #
#  \  #
L  .  #
#######